xxxxxxxxxxxxxxxxxxxxxxxxxxxxxxxxxxxxxxxxxxxxxxxxxxxxxxxxxxxxxxxxxxxxxxxxxxxxxxxx
x______________________________________________________________________________x
x__________________________fff_________________________________________________x
x_________________________fffff______________~~~~~~____________________________x
x_________________________ffffff___________~~~~~~~~~___________________________x
x___________________________fff___________~~~~~~~~~~~~_________________________x
x___________________________________________~~~~~~_____________________________x
x_____________________MMMMMMMMMMM______________________________________________x
x__________________MMMMMMMMMMMMMMMM____________________________________________x
x________________MMMMMMMMMMMMMMMMMMM______________fff__________________________x
x_______________MMMMMMMMMMMMMMMMMMMMM___________ffffff_________________________x
x______________MMMMMMMMMMMMMMMMMMMMMMM__________fffffffff______________________x
x_________________MMMMMMMMMMMMMMMMMM_____________ffffff________________________x
x____________________MMMMMMMMMMM___________________fff_________________________x
x_____________________________________________________________________________~x
x_________________________~~~~~_______________________________________________~x
x_______________________~~~~~~~~~_____________________________________________~x
x_______________________~~~~~~~~~______________________MMMMM___________________x
x________________________~~~~~_______________________MMMMMMMMM_________________x
x___________________________________________________MMMMMMMMMMM________________x
x_________________________fff_______________________MMMMMMMMMMMMM______________x
x________________________fffff________________________MMMMMMMMMMM______________x
x_______________________fffffff_________________________MMMMMMMMM______________x
x________________________fffff_________________________________________________x
x__________________________f___________________________________________________x
x______________________________________________________________________________x
x_____________MMM______________________________________________________________x
x____________MMMMMM________________~~~~~~~~____________________________________x
x___________MMMMMMMM______________~~~~~~~~~~~__________________________________x
x____________MMMMMM_______________~~~~~~~______________________________________x
x______________MMM_____________________________________________________________x
x______________________________________________________________________________x
x_________________________fff__________________________________________________x
x_______________________fffffff___________MMMMMM_______________________________x
x______________________fffffffff________MMMMMMMMMM_____________________________x
x_______________________fffffff________MMMMMMMMMMMMM___________________________x
x_________________________fff___________MMMMMMMMMM_____________________________x
x_________________________________________MMMMM________________________________x
x______________________________________________________________________________x
x______________________________________________________________________________x
xxxxxxxxxxxxxxxxxxxxxxxxxxxxxxxxxxxxxxxxxxxxxxxxxxxxxxxxxxxxxxxxxxxxxxxxxxxxxxxx
