xxxxxxxxxxxxxxxxxxxxxxxxxxxxxxxxxxxxxxxxxxxxxxxxxxxxxxxxxxxxxxxxxxxxxxxxxxxxxxxxxxxxxxxxxxxxxxxxxxxxxxxxxxxxxxxxxxxxxxxxxxxxxxxxxxxxxxxxxxxxxxxxxxxxxx
x____________________________________________________________________________________________________________________________________________________x
x____________________________________________________________________________________________________________________________________________________x
x_______________________________________________________________~~~~~~~______________________________________________________________________________x
x_______________________________________________________________~~~~~~~______________________________________________________________________________x
x___________________MMMMMMMMM________________________________________________________________________________________________________________________x
x___________________MMMMMMMMM________________________________________________________________________________________________________________________x
x___________________MMMMMMMMM__________________________________________________fffff______________________________________________MMMMMMMMMMMMMM_____x
x___________________MMMMMMMMM__________________________________________________fffff______________________________________________MMMMMMMMMMMMMM_____x
x___________________MMMMMMMMM__________________________________________________fffff______________________________________________MMMMMMMMMMMMMM_____x
x____________________________________________________________________________________________________________________________________________________x
x______________________________________________fffffff_______________________________________________________________________________________________x
x______________________________________________fffffff_______________________________________________________________________________________________x
x______________________________________________fffffff_______________________________________________________________________________________________x
x____________________________________________________________________________________________________________________________________________________x
x______________________________MMMMMMM_______________________________________________________________________________________________________________x
x______________________________MMMMMMM_______________________________________________________________________________________________________________x
x______________________________MMMMMMM__________________________________________________~~~~~_____________________________________MMMMMMMMMMMMMMMMMMMx
x______________________________MMMMMMM__________________________________________________~~~~~_____________________________________MMMMMMMMMMMMMMMMMMMx
x______________________________MMMMMMM__________________________________________________~~~~~_____________________________________MMMMMMMMMMMMMMMMMMMx
x______________________________MMMMMMM_______________________________________________________________________________________________________________x
x______________________________MMMMMMM_______________________________________________________________________________________________________________x
x______________________________MMMMMMM_______________________________________________________________________________________________________________x
x____________________________________________________________________________________________________________________________________________________x
x____________________________________________________________________fffffff_________________________________________________________________________x
x__~____~____________________________________________________________fffffff_________________________________________________________________________x
x__~____~____________________________________________________________fffffff_________________________________________________________________________x
x__~____~___________________________________________MMMMMMMMMMMMMMMMMMMMMMMMMMMMMMMMMMMMM____________________________________________________________x
x__~____~___________________________________________MMMMMMMMMMMMMMMMMMMMMMMMMMMMMMMMMMMMM____________________________________________________________x
x__~____~___________________________________________MMMMMMMMMMMMMMMMMMMMMMMMMMMMMMMMMMMMM____________________________________________________________x
x__~____~____________________________________________________________________________________________________________________________________________x
x__~____~____________________________________________________________________________________________________________________________________________x
x__~____~____________________________________________________________________________________________________________________________________________x
x__~____~____________________________________________________________________________________________________________________________________________x
x__~____~_____________________________________________________________~~~~~~~~~______________________________________________________________________x
x__~____~_____________________________________________________________~~~~~~~~~______________________________________________________________________x
x__~____~_____________________________________________________________~~~~~~~~~______________________________________________________________________x
x__~____~____________________________________________________________________________________________________________________________________________x
x__~____~_______________________MMMMMM_______________________________________________________________________________________________________________x
x__~____~_______________________MMMMMM_______________________________________________________________________________________________________________x
x__~____~_______________________MMMMMM_______________________________fff_____________________________________________________________________________x
x__~____~_______________________MMMMMM_______________________________fff_____________________________________________________________________________x
x__~____~_______________________MMMMMM_______________________________fff_____________________________________________________________________________x
x__~____~_______________________MMMMMM_______________________________fff_____________________________________________________________________________x
x__~____~____________________________________________________________________________________________________________________________________________x
x__~____~____________________________________________________________________________________________________________________________________________x
x__~____~____________________________~~~~~___________________________________________________________________________________________________________x
x__~____~____________________________~~~~~___________________________________________________________________________________________________________x
x__~____~____________________________~~~~~___________________________________________________________________________________________________________x
x__~____~____________________________________________________________________________________________________________________________________________x
x__~____~____________________________________________________________________________________________________________________________________________x
x__~______________________________MMMMMMMMMMMMMM_____________________________________________________________________________________________________x
x__~______________________________MMMMMMMMMMMMMM_____________________________________________________________________________________________________x
x__~______________________________MMMMMMMMMMMMMM_____________________________________________________________________________________________________x
x__~______________________________MMMMMMMMMMMMMM_____________________________________________________________________________________________________x
x__~_________________________________________________________________________________________________________________________________________________x
x__~_________________________________________________________________________________________________________________________________________________x
x__~_________________________________________________________________________________________________________________________________________________x
x__~____MMMMMMMMMMMMMMMMMMMMMMMMMMMMMMMMMMMMMMMMMMMMMMMMMMMMMMMMMMMMMMMMMMMMMMMMMMMMMMMMMMMMMMMMMMMMMMMMMMMMMMMMMMMMMMMMMMMMMMMMMMMMMMMMMMMMMM_______x
x__~_________________________________________________________________________________________________________________________________________________x
x__~_________________________________________________________________________________________________________________________________________________x
x__~_________________________________________________________________________________________________________________________________________________x
x__~____fffff________________________________________________________________________________________________________________________________________x
x__~____fffff________________________________________________________________________________________________________________________________________x
x__~____fffff________________________________________________________________________________________________________________________________________x
x__~_________________________________________________________________________________________________________________________________________________x
x__~_________________________________________________________________________________________________________________________________________________x
x____________________________________________________________________________________________________________________________________________________x
x____________________________________________________________________________________________________________________________________________________x
x____________________________________________________________________________________________________________________________________________________x
x____________________________________________________________________________________________________________________________________________________x
x____________________________________________________________________________________________________________________________________________________x
x____________________________________________________________________________________________________________________________________________________x
x____________________________________________________________________________________________________________________________________________________x
x____________________________________________________________________________________________________________________________________________________x
x____________________________________________________________________________________________________________________________________________________x
xxxxxxxxxxxxxxxxxxxxxxxxxxxxxxxxxxxxxxxxxxxxxxxxxxxxxxxxxxxxxxxxxxxxxxxxxxxxxxxxxxxxxxxxxxxxxxxxxxxxxxxxxxxxxxxxxxxxxxxxxxxxxxxxxxxxxxxxxxxxxxxxxxxxxx